分端 流量 入口 观众 直播间 行为 流量 入口 观众 直播间 行为 业务 直播间 行为 直播间 行为 抖 流量 入口 垂直 场景 交叉 流量 入口 垂直 场景 交叉 分端 直播间 行为 直播间 行为 直播间 直播间 抖音 业务 直播间 拆分 抖音 业务 直播间 拆分 流量 行为 房间 付费 房间 付费 房间 流量 行为 房间 流量 行为 用户 直播间 用户 直播间 行为 观众 主播 交叉 识别 西瓜 头条 用户 主播 交叉 西瓜 头条 用户 主播 交叉 分析 房间 付费 房间 付费 抖音 核心 归因 	直播间-互动
分端 流量 入口 观众 直播间 行为 流量 入口 观众 直播间 行为 抖 流量 入口 垂直 场景 交叉 流量 入口 垂直 场景 交叉 直播间 直播间 分端 观众 行为 业务 观众 行为 直播 抖音 视频 关注 关系 用户 关注 业务 用户 关注 抖火 业务 用户 关注 关系 用户 关注 分端 用户 行为 抖火 观众 抖火 观众 业务 观众 关注 观众 关注 用户 直播间 用户 直播间 行为 观众 主播 交叉 识别 西瓜 头条 用户 主播 交叉 西瓜 头条 用户 主播 交叉 分析 观众 主播 交叉 行为 观众 主播 交叉 行为 观众 主播 交叉 行为 观众 主播 交叉 行为 开播 过程 用户 行为 直播 场景 客户端 sdk 业务 直播 用户 行为 直播间 行为 开播 过程 用户 行为 直播 场景 直播 客户端 sdk 开播 过程 用户 行为 直播 场景 曝光 客户端 sdk 业务 直播间 曝光 用户 行为 直播间 行为 埋点 直播间 曝光 开播 过程 用户 行为 直播 场景 关注 客户端 sdk 开播 过程 用户 行为 直播 场景 送礼 客户端 sdk 开播 过程 用户 行为 直播 场景 预览 观看 客户端 sdk 开播 过程 用户 行为 直播 场景 预览 观看 客户端 sdk 开播 过程 用户 行为 直播 场景 客户端 sdk 开播 过程 用户 行为 直播 场景 客户端 sdk 开播 过程 用户 行为 直播 场景 客户端 sdk 业务 直播 用户 行为 直播间 行为 开播 过程 用户 行为 主播 流量 行为 直播 场景 关注 客户端 sdk 开播 过程 用户 行为 主播 流量 行为 直播 场景 关注 客户端 sdk 开播 过程 用户 行为 直播 场景 客户端 sdk 开播 过程 用户 行为 直播 场景 客户端 sdk 开播 过程 用户 行为 直播 场景 粉丝团 客户端 sdk 钻石 开播 过程 用户 行为 直播 场景 红包 客户端 sdk 钻石 开播 过程 用户 行为 看播 直播 场景 直播 观看 直播 客户端 sdk 开播 过程 用户 行为 直播 场景 客户端 sdk 开播 过程 用户 行为 直播 场景 内送 道具 客户端 sdk 开播 过程 用户 行为 直播 场景 送礼 客户端 sdk 用户数 开播 过程 用户 行为 主播 流量 行为 直播 场景 内送 道具 客户端 sdk 钻石 开播 过程 用户 行为 主播 流量 行为 直播 场景 内送 道具 客户端 sdk 开播 过程 用户 行为 粉丝 业务 直播 场景 直播 客户端 sdk 开播 过程 用户 行为 直播 场景 客户端 sdk 用户数 开播 过程 用户 行为 直播 场景 粉丝团 客户端 sdk 用户数 开播 过程 用户 行为 粉丝 业务 直播 场景 曝光 客户端 sdk 开播 过程 用户 行为 预览 看播 直播 场景 预览 观看 客户端 sdk 开播 过程 用户 行为 粉丝 业务 直播 场景 客户端 sdk 开播 过程 用户 行为 看播 直播 场景 直播 观看 直播 客户端 sdk 用户数 举报 举报 举报 开播 过程 用户 行为 粉丝 业务 直播 场景 客户端 sdk 用户数 举报 举报 举报 举报 举报 举报 举报 用户数 举报 用户数 举报 举报 举报 直播间 举报 举报 直播间 举报 举报 举报 用户数 举报 举报 用户数 举报 举报 直播间 举报 直播间 举报 举报 直播间 举报 直播间 举报 粉丝 业务 举报 粉丝 举报 关注 状态 举报 状态 观众 动态 观众 动态 	观众-互动
分端 流量 入口 观众 直播间 行为 流量 入口 观众 直播间 行为 业务 主播 行为 主播 开播 观看 行为 直播 业务 维度 业务 关系 业务 直播间 行为 直播间 行为 分端 主播 行为 主播 开播 观看 行为 抖 流量 入口 垂直 场景 交叉 流量 入口 垂直 场景 交叉 分端 直播间 行为 直播间 行为 分端 观众 行为 业务 观众 行为 直播 流量 入口 直播 流量 入口 社区 集市 直播 社区 集市 直播 房间 流量 行为 房间 流量 行为 用户 直播间 用户 直播间 行为 观众 主播 交叉 识别 观众 主播 交叉 行为 观众 主播 交叉 行为 抖音 火山 直播间 流量 入口 	用户社区-基础建设
分端 流量 入口 观众 直播间 行为 流量 入口 观众 直播间 行为 业务 主播 行为 主播 开播 观看 行为 抖音 火山 业务 主播 开播 观看 行为 主播 业务 主播 粉丝 主播 粉丝 分端 主播 行为 主播 开播 观看 行为 抖 流量 入口 垂直 场景 交叉 流量 入口 垂直 场景 交叉 分端 用户 行为 抖音 火山 主播 开播 观看 行为 抖音 火山 主播 开播 观看 行为 主播 运营 主播 自然 自然 观众 主播 交叉 识别 西瓜 头条 用户 主播 交叉 西瓜 头条 用户 主播 交叉 分析 观众 主播 交叉 行为 观众 主播 交叉 行为 分端 主播 行为 主播 行为 观众 主播 交叉 行为 观众 主播 交叉 行为 中心 主播 行为 开播 主播 中心 主播 行为 开播 主播 用户 送礼 分成 收入 出账 用户数 主播 直播 收入 礼物 送礼 用户数 马甲 用户 抖音 核心 归因 	主播-互动
用户 消费 主播 房间 交叉 营收 消费 观众 消费 关系 直播 历史 消费 关系 业务 历史 消费 关系 用户 交叉 主播 用户 用户 消费 主播 消费 用户 消费 主播 消费 核心 抖火 用户 画像 用户 消费 主播 交叉 	主播-消费
用户 消费 主播 房间 交叉 营收 消费 房间 付费 房间 付费 房间 付费 房间 付费 	直播间-消费
用户 消费 主播 房间 交叉 营收 消费 观众 付费 观众 付费 观众 付费 观众 付费 观众 付费 观众 付费 观众 消费 关系 观众 礼物 消费 观众 礼物 消费 观众 付费 观众 付费 用户 付费 分端 用户 付费 分端 直播 历史 消费 关系 业务 历史 消费 关系 用户 交叉 主播 用户 用户 消费 主播 消费 用户 消费 主播 消费 观众 礼物 消费 观众 礼物 消费 开播 过程 用户 行为 直播 场景 送礼 客户端 sdk 钻石 核心 抖火 核心 用户 消费 用户 画像 用户 消费 主播 交叉 分成 收入 出账 用户数 主播 直播 收入 消费 用户数 用户 分成 收入 出账 用户数 主播 直播 收入 消费 用户数 马甲 用户 分成 收入 出账 用户数 主播 直播 收入 消费 用户数 马甲 用户 直播 付费 流转 分析 用户 送礼 收入 分成 收入 出账 用户数 主播 直播 收入 礼物 送礼 用户数 马甲 用户 马甲 用户 送礼 收入 分成 收入 出账 用户数 主播 直播 收入 礼物 送礼 马甲 用户数 用户 分成 收入 出账 用户数 主播 直播 收入 消费 用户数 马甲 用户 分成 收入 出账 用户数 主播 直播 收入 消费 用户数 马甲 用户 马甲 用户 分成 收入 出账 用户数 主播 直播 收入 消费 马甲 用户数 马甲 用户 分成 收入 消费 钻石 主播 直播 收入 马甲 用户 消费 虚拟 	观众-消费
直播间 业务 房间 直播间 房间 开播 过程 流量 房间 开播 过程 流量 	直播间-开播
直播间 业务 房间 直播间 业务 主播 行为 主播 开播 观看 行为 分端 主播 行为 主播 开播 观看 行为 核心 主播 运营 主播 开播 主播 开播 结算 业务 主播 行为 主播 行为 开播 直播 开播 开播 直播 开播 开播 直播间 开播 开播 直播 直播 直播 直播间 开播 开播 直播 直播 直播 开播 直播 开播 直播 直播 自然 分成 结算 主播 行为 开播 直播 直播 自然 分成 结算 主播 行为 直播 主播 拆分 开播 开播 直播 开播 开播 直播 直播 开播 直播间 开播 直播 直播 自然 分成 结算 主播 行为 历史 开播 历史 直播 直播 自然 分成 结算 主播 行为 开播 直播 直播 自然 分成 结算 主播 行为 直播间 处置 处置 直播 权限 封禁 直播间 开播 直播 直播 自然 分成 结算 主播 行为 历史 直播间 开播 开播 历史 直播 直播 直播 自然 分成 结算 主播 行为 开播 直播 直播 自然 分成 结算 主播 行为 开播 开播 直播间 开播 主播 开播 开播 开播 直播间 开播 主播 开播 历史 开播 开播 直播 自然 分成 结算 主播 行为 历史 主播 开播 开播 直播间 开播 主播 开播 历史 开播 历史 直播 直播 自然 分成 结算 主播 行为 历史 开播 历史 直播 直播 自然 分成 结算 主播 行为 直播间 开播 开播 直播 直播 直播 自然 分成 结算 主播 行为 直播间 开播 开播 直播 直播 直播 自然 分成 结算 主播 行为 直播间 开播 开播 直播 直播 直播 自然 分成 结算 主播 行为 历史 直播间 开播 开播 历史 直播 直播 直播 自然 分成 结算 主播 行为 历史 直播 开播 历史 直播 直播 直播间 直播 直播 开播 直播 开播 历史 主播 开播 开播 开播 直播 自然 分成 结算 主播 行为 直播 开播 直播 直播 直播间 历史 直播 开播 历史 直播 直播间 	主播-开播
主播 用户 用户 用户 设备 用户 设备 用户 设备 设备 维度 抖火 业务 主播 扩展 扩展 主播 签约 签约 主播 白名单 主播 白名单 主播 西瓜 业务 主播 扩展 扩展 西瓜 业务 主播 主播 签约 	主播-基础
直播 安全 直播 安全 主播 主播 标签 主播 标签 主播 主播 主播 主播 治理 主播 违规 治理 场景 违规 主播 治理 主播 违规 治理 场景 违规 主播 违规 主播 违规 违规 主播 违规 主播 违规 违规 用户 申诉 申诉 直播 安全 核心 治理 生态 健康 	生态健康-机防能力
直播 安全 直播 安全 直播 用户 权限 惩罚 状态 直播 用户 权限 直播 中台 主播 审核 直播 中台 主播 审核 直播间 直播 直播间 审核 直播 直播间 审核 分端 直播间 安全 审核 分端 直播间 安全 审核 分端 主播 审核 分端 主播 审核 用户 封禁 状态 全量表 	生态健康-基础建设
直播 安全 直播 安全 审核 核心 审核 审核 生态 健康 审核 核心 直播 安全 直播 生态 健康 生态 健康 审核 直播 安全 主播 监控 生态 健康 审核 直播 安全 生态 健康 	生态健康-人防能力
用户 用户 直播间 标签 直播间 标签 投票 直播 预约 用户 状态 直播 预约 用户 状态 直播间 扩展 	直播间-功能
业务 主播 核心 分层 标签 核心 分层 标签 用户 画像 主播 画像 业务 主播 维度 业务 用户 画像 基础 画像 用户 基础 分端 用户 行为 业务 直播 用户 画像 行为 用户 行为 分端 直播 用户 画像 观众 主播 关系 用户 主播 关系 行为 用户 画像 主播 画像 标签 用户 画像 主播 画像 标签 主播 内容 标签 主播 内容 标签 场景 分端 主播 直播 用户 画像 直播 用户 画像 用户 画像 主播 画像 	主播-画像
主播 收入 主播 主播 收入 全量表 主播 收入 流水 用户 消费 平台 运营 视频 收入 主播 收入 主播 主播 收入 全量表 主播 收入 历史 全量表 主播 收入 流水 全量表 用户 消费 平台 运营 视频 收入 主播 主播 收入 房间 交叉 收入 房间 消费 用户 分成 收入 大盘 主播 收入 直播 主播 分成 收入 直播 中台 付费 连线 送礼 粉丝团 道具 直播 特权 弹幕 荣誉 盲盒 送礼 装扮 游戏 付费 会员 订阅 会员 订阅 生态 玩法 主播 分成 分成 收入 用户 分成 收入 主播 收入 直播 主播 分成 收入 直播 中台 付费 连线 送礼 粉丝团 道具 直播 特权 弹幕 荣誉 盲盒 送礼 装扮 游戏 付费 会员 订阅 会员 订阅 生态 玩法 主播 分成 分成 收入 用户 分成 收入 主播 收入 直播 主播 分成 收入 直播 中台 付费 连线 送礼 粉丝团 道具 直播 特权 弹幕 荣誉 盲盒 送礼 装扮 游戏 付费 会员 订阅 会员 订阅 生态 玩法 主播 分成 分成 收入 用户 分成 收入 消费 钻石 主播 直播 收入 用户 消费 虚拟 马甲 用户 用户 分成 收入 消费 钻石 主播 直播 收入 用户 消费 虚拟 马甲 用户 分成 收入 分成 收入 分成 收入 收入 主播 直播 收入 收入 用户 分成 收入 消费 钻石 主播 直播 收入 用户 消费 虚拟 马甲 用户 历史 用户 分成 收入 消费 钻石 主播 直播 收入 用户 消费 虚拟 马甲 用户 马甲 用户 分成 收入 消费 钻石 主播 直播 收入 马甲 用户 消费 虚拟 分成 收入 收入 主播 直播 收入 马甲 用户 分成 收入 出账 用户数 主播 直播 收入 消费 马甲 用户数 用户 分成 收入 出账 用户数 主播 直播 收入 消费 用户数 马甲 用户 历史 用户 送礼 分成 收入 消费 钻石 主播 直播 收入 礼物 用户 送礼 消费 虚拟 马甲 用户 历史 用户 分成 收入 主播 直播 马甲 用户 主播 收入 直播 主播 分成 收入 直播 中台 付费 连线 送礼 粉丝团 道具 直播 特权 弹幕 荣誉 盲盒 送礼 装扮 游戏 付费 会员 订阅 会员 订阅 生态 玩法 主播 分成 分成 收入 历史 马甲 用户 送礼 分成 收入 消费 钻石 主播 直播 收入 礼物 马甲 用户 送礼 消费 虚拟 历史 马甲 用户 分成 收入 消费 钻石 主播 直播 收入 马甲 用户 消费 虚拟 用户 送礼 分成 收入 消费 钻石 主播 直播 收入 礼物 用户 送礼 消费 虚拟 马甲 用户 分成 收入 主播 收入 游戏 主播 收入 收入 用户 消费 虚拟 平台 虚拟 主播侧 收入 历史 分成 收入 主播 收入 直播 主播 分成 收入 直播 中台 付费 连线 送礼 粉丝团 道具 直播 特权 弹幕 荣誉 盲盒 送礼 装扮 游戏 付费 会员 订阅 会员 订阅 生态 玩法 主播 分成 分成 收入 分成 收入 平台 金额 主播 直播 收入 平台 金额 分成 收入 平台 金额 主播 直播 收入 平台 金额 历史 分成 收入 主播 会员 游戏 生态 马甲 用户 虚拟 马甲 用户 分成 收入 消费 钻石 主播 直播 收入 马甲 用户 消费 虚拟 分成 收入 出账 用户数 主播 直播 收入 消费 用户数 任务 结算 任务 收入 金额 主播 任务 收入 分成 结算 分成 收入 金额 基础 分成 收入 用户 分成 收入 出账 用户数 主播 直播 收入 消费 用户数 马甲 用户 马甲 用户 送礼 收入 分成 收入 消费 钻石 主播 直播 收入 礼物 马甲 用户 送礼 消费 虚拟 分成 收入 出账 用户数 主播 直播 收入 消费 用户数 马甲 用户 用户 送礼 收入 分成 收入 出账 用户数 主播 直播 收入 礼物 送礼 用户数 马甲 用户 分成 收入 主播 收入 直播 主播 分成 收入 直播 中台 付费 连线 送礼 粉丝团 道具 直播 特权 弹幕 荣誉 盲盒 送礼 装扮 游戏 付费 会员 订阅 会员 订阅 生态 玩法 主播 分成 分成 收入 用户 送礼 收入 分成 收入 消费 钻石 主播 直播 收入 礼物 用户 送礼 消费 虚拟 马甲 用户 马甲 用户 送礼 分成 收入 消费 钻石 主播 直播 收入 礼物 马甲 用户 送礼 消费 虚拟 马甲 用户 送礼 分成 收入 出账 用户数 主播 直播 收入 礼物 送礼 马甲 用户数 马甲 用户 送礼 收入 分成 收入 出账 用户数 主播 直播 收入 礼物 送礼 马甲 用户数 分成 收入 主播 收入 直播 主播 分成 收入 直播 中台 付费 连线 送礼 粉丝团 道具 直播 特权 弹幕 荣誉 盲盒 送礼 装扮 游戏 付费 会员 订阅 会员 订阅 生态 玩法 主播 分成 分成 收入 马甲 用户 送礼 收入 分成 收入 消费 钻石 主播 直播 收入 礼物 马甲 用户 送礼 消费 虚拟 用户 分成 收入 出账 用户数 主播 直播 收入 消费 用户数 马甲 用户 分成 收入 平台 金额 平台 金额 马甲 用户 送礼 收入 分成 收入 出账 用户数 主播 直播 收入 礼物 送礼 马甲 用户数 用户 送礼 收入 分成 收入 消费 钻石 主播 直播 收入 礼物 用户 送礼 消费 虚拟 马甲 用户 分成 收入 出账 用户数 主播 直播 收入 消费 用户数 马甲 用户 马甲 用户 分成 收入 出账 用户数 主播 直播 收入 消费 马甲 用户数 马甲 用户 分成 收入 出账 用户数 主播 直播 收入 消费 马甲 用户数 马甲 用户 分成 收入 消费 钻石 主播 直播 收入 马甲 用户 消费 虚拟 用户 送礼 收入 分成 收入 出账 用户数 主播 直播 收入 礼物 送礼 用户数 马甲 用户 分成 结算 分成 收入 金额 结算 用户 付费 付费 分成 收入 会员 订阅 收入 会员 收入 分成 收入 收入 游戏 主播 收入 中心 主播 收入 游戏 场景 关注 分成 收入 主播 直播 马甲 用户 游戏 玩法 场景 主播 分成 收入 分成 收入 生态 玩法 游戏 玩法 生态 玩法 收入 	主播-收入
直播 消费 账户 账户 消费 流水 基础 火山 抖音 西瓜 消费 流水 火山 抖音 西瓜 账户 账户 消费 流水 全量表 账户 账户 PK 营收 PK 营收 PK PK 直播 付费 内容 直播 付费 内容 用户 消费 订单 流水 送礼 订单 直播 交易 直播 业务 用户 直播 平台 交易 	直播钱包-消费流水
主播 切片 投票 标签 主播 切片 投票 标签 开播 模型 主播 方舟 主播 主播 内容 标签 主播 内容 标签 内容 标签 内容 标签 内容 标签 主播 切片 投票 标签 切片 投票 标签 主播 运营 标签 运营 标签 新主播 垂类 主播 内容 标签 主播 内容 标签 场景 垂类 看播 打赏 内容 监控 垂类 垂类 主播 标签 垂类 监测 内容 垂类 主播 核心 监控 	主播-内容
业务 主播 粉丝 主播 粉丝 抖 流量 入口 垂直 场景 交叉 流量 入口 垂直 场景 交叉 直播 抖音 视频 关注 关系 用户 关注 业务 用户 关注 直播 用户 粉丝团 关系 直播 用户 粉丝团 关系 抖火 业务 用户 关注 关系 用户 关注 观众 消费 关系 主播侧 粉丝团 主播侧 粉丝团 分端 主播 粉丝 观众 主播 交叉 行为 观众 主播 交叉 行为 	主播-关系
直播 公会 公会 画像 公会 分层 建联 建联 主播 主播 公会 运营 标签 公会 运营 标签 公会 公会 主播 公会 主播 主播 主播 运营 公会 拉新 直播间 招募 公会 公会 等级 主播 监控 公会 	主播-机构
分端 直播 用户 画像 观众 核心 分层 标签 观众 核心 分层 标签 业务 用户 画像 用户 画像 业务 内容 直播 画像 平台 用于 业务 标签 业务 用户 画像 基础 画像 用户 基础 直播 付费 用户 付费 分端 直播 付费 用户 付费 分端 用户 行为 业务 直播 用户 画像 行为 用户 行为 分端 直播 用户 画像 观众 主播 关系 用户 主播 关系 行为 用户 行为 分端 直播 用户 画像 行为 画像 用户 行为 分端 直播 用户 画像 观众 分端 直播 用户 画像 观众 直播 付费 用户 付费 业务 直播 付费 用户 付费 业务 直播 用户 画像 直播 用户 画像 用户 画像 用户 消费 主播 交叉 	观众-画像
用户 用户 用户 设备 用户 设备 用户 设备 设备 维度 抖音 账号 账号 关系 抖音 账号 账号 关系 用户 用户 权限 	观众-基础
观众 主播 连麦 观众 主播 连麦 观众 连麦 垂直 场景 消费 用户 房间 交叉 多人 场景 线上 玩法 组件 组件 抖 聊天室 聊天室 抖 聊天室 行为 聊天室 行为 垂直 场景 消费 流水 基础 多人 场景 主播 收入 订单 场景 主播 收入 订单 多人 玩法 订单 玩法 订单 多人 场景 聊天室 聊天室 多人 场景 玩法 流水 场景 玩法 流水 多人 场景 玩法 主播 场景 玩法 主播 多人 场景 玩法 连线 多人 场景 玩法 连线 多人 玩法 订单 玩法 订单 垂直 场景 消费 流水 基础 消费 多人 玩法 垂直 场景 订单 玩法 垂直 场景 订单 	多人场景-基础建设
观众 主播 连麦 观众 主播 连麦 观众 连麦 主播 连麦 主播 连麦 连麦 用户 最后 连麦 用户 最后 行为 时间 分端 互动 社交 看播 连线 用户 画像 标签 	功能-连麦
直播间 举报 全量表 直播间 举报 全量表 直播间 举报 直播间 举报 直播间 弹幕 举报 全量表 举报 弹幕 直播间 弹幕 举报 全量表 举报 弹幕 直播 房间 举报 直播 房间 举报 客服 举报 申诉 客服 举报 申诉 直播间 举报 直播间 举报 主播 举报 主播 举报 生态 健康 举报 直播间 生态 治理 举报 核心 生态 健康 直播间 举报 举报 监控 生态 健康 客服 举报 申诉 生态 健康 	生态健康-专项-举报
结算 结算 打赏 任务 任务 平台 结算 用户 	直播钱包-清结算
主播 方舟 主播 方舟 用户 账号 方舟 用户 账号 主播 主播 方舟 流量 方舟 方舟 签约 主播 签约 主播 主播 主播 经纪人 分析 方舟 核心 大盘 方舟 核心 方舟 核心 方舟 主播 运营 监控 方舟 建联 	用户社区-方舟
主播 方舟 主播 垂类 主播 主播 垂类 关系 垂类 主播 主播 运营 标签 运营 标签 新主播 垂类 主播 内容 标签 主播 内容 标签 场景 垂类 主播 关系 垂类 主播 主播 多人 垂类 垂类 主播 垂类 看播 打赏 内容 监控 垂类 垂类 垂类 打赏 项目 流量 垂类 主播 	主播中心-内容运营
用户 用户 用户 用户 生态 健康 生态 健康 标签 监控 生态 健康 场景 核心 生态 健康 核心 	生态健康-专项-其他
抖 流量 入口 垂直 场景 交叉 流量 入口 垂直 场景 交叉 直播 抖音 视频 关注 关系 用户 关注 业务 用户 关注 抖火 业务 用户 关注 关系 用户 关注 观众 消费 关系 业务 观众 关注 观众 关注 观众 主播 交叉 行为 观众 主播 交叉 行为 	观众-关系
直播间 直播间 房间 开播 直播间 扩展 	功能-评论
直播 用户 权限 惩罚 状态 直播 用户 权限 vip 安全 	观众-安全
直播 用户 权限 惩罚 状态 直播 用户 权限 直播 中台 主播 审核 直播 中台 主播 审核 分端 主播 审核 分端 主播 审核 主播 举报 主播 举报 抖音 火山 举报 监控 举报 举报 举报 举报 举报 举报 举报 用户数 举报 用户数 申诉 直播 权限 封禁 账号 封禁 封禁 封禁 申诉 申诉 直播 权限 直播间 处置 封禁 连麦 权限 封禁 处置 主播 连麦 权限 申诉 审核 直播 权限 封禁 账号 封禁 申诉 封禁 封禁 申诉 申诉 直播 权限 申诉 直播 权限 封禁 生态 健康 封禁 封禁 申诉 申诉 申诉 审核 直播 权限 封禁 生态 健康 申诉 封禁 封禁 申诉 申诉 举报 举报 举报 用户数 举报 举报 用户数 直播间 处置 封禁 直播 权限 账号 封禁 封禁 处置 封禁 直播 权限 封禁 账号 封禁 举报 粉丝 业务 举报 粉丝 举报 关注 状态 举报 状态 公会 健康 违规 任务 审核 生态 健康 公会 治理 	主播-安全
互动 弹幕 游戏 房间 弹幕 游戏 房间 营收 弹幕 生态 玩法 核心 弹幕 玩法 弹幕 玩法 流水 归因 弹幕 生态 玩法 营收 	营收产品-弹幕玩法
游戏 主播 用户 交叉 游戏 主播 用户 交叉 直播 游戏 玩法 消费 流水 盲盒 营收 游戏 生态 游戏 观众 游戏 玩法 游戏 消费 分端 付费 观众 游戏 玩法 游戏 消费 分端 付费 营收 游戏 玩法 核心 营收 游戏 玩法 流水 归因 营收 游戏 玩法 营收 营收 游戏 玩法 日报 营收 游戏 玩法 	营收产品-营收玩法
活动 组件 识别 抖火 抖火 权限 多人 集市 直播 埋点 直播 平台 平台 项目管理 平台 抖火 项目管理 平台 抖火 全量表 权限 	用户社区-盖亚
双人 PK 直播 PK 全量表 双人 PK 直播 pk 全量表 PK 双人 多人 pk 多人 pk 多人 pk 全量表 PK 双人 多人 直播 PK PK PK 双人 PK 多人 PK PK 营收 pk 场次 抖 流量 入口 pk 流量 交叉 流量 入口 连屏 流量 交叉 时间 分析 PK 营收 PK 营收 PK PK pk 彩蛋 消费 订单 pk 彩蛋 消费 订单 pk 订单 pk 用户 pk 用户 主播 收入 流水 用户 消费 平台 运营 视频 收入 PK 业务 主播 PK 场次 多人 双人 PK 消费 pk 封禁 营收 连屏 封禁 主播 pk 任务 pk 任务 任务 任务 PK pk pk 场景 垂类 主播 核心 直播 pk 	营收产品-pk
双人 PK 直播 PK 全量表 双人 PK 直播 pk 全量表 PK 双人 多人 pk 多人 pk 多人 pk 全量表 PK 双人 多人 直播 PK PK PK 双人 PK 多人 PK PK 营收 pk 场次 抖 流量 入口 pk 流量 交叉 流量 入口 连屏 流量 交叉 时间 分析 PK 营收 PK 营收 PK PK pk 彩蛋 消费 订单 pk 彩蛋 消费 订单 pk 订单 pk 用户 pk 用户 主播 收入 流水 用户 消费 平台 运营 视频 收入 PK 业务 主播 PK 场次 多人 双人 PK 消费 pk 封禁 营收 连屏 封禁 主播 pk 任务 pk 任务 任务 任务 主播 双人 PK 互关 行为 主播 双人 PK 互关 行为 互关 pk 业务 互关 PK pk pk 场景 垂类 主播 核心 直播 pk 	功能-pk
节目 集市 付费 直播 付费 直播 VS 节目 营收 付费 订单 付费 直播 订单 退款 状态 全量表 付费 直播 订单 退款 状态 全量表 离线 付费 直播 核心 离线 付费 直播 离线 付费 直播 	直播节目-付费直播
抖火 业务 直播间 扩展 业务 房间 核心 抖火 业务 房间 扩展 西瓜 业务 直播间 扩展 开播 房间 核心 西瓜 业务 房间 扩展 	直播间-基础
会员 订阅 主播 主播 用户 内容 订阅 关系 订阅 订阅 关系 会员 订阅 主播 会员 订阅 会员 订阅 会员 订阅 主播 会员 业务 运营 	多人场景-会员订阅
会员 订阅 主播 主播 抖 聊天室 聊天室 抖 聊天室 行为 聊天室 行为 主播侧 粉丝团 主播侧 粉丝团 PK 业务 主播 PK 场次 多人 双人 PK 消费 用户 	主播-功能
社区 大盘 核心 大盘 核心 社区 核心 大盘 社区 核心 大盘 直播 营收 核心 账户 拆分 直播 营收 核心 账户 拆分 直播 大盘 营收 核心 直播 大盘 营收 核心 社区 粉丝 社区 核心 社区 核心 核心 抖火 营收 核心 营收 核心 社区 用户 直播 业务 核心 核心 用户 消费 运营 核心 运营 核心 核心 抖火 	核心指标-大盘
多人 场景 线上 玩法 组件 组件 抖 行为 行为 抖火 抖火 多人 玩法 业务 业务 核心 多人 场景 核心 多人 场景 玩法 	多人场景-K歌业务
直播 用户 粉丝团 关系 直播 用户 粉丝团 关系 主播侧 粉丝团 主播侧 粉丝团 粉丝团 行为 粉丝团 粉丝团 任务 任务 消费 交叉 粉丝团 任务 任务 电商 任务 粉丝团 任务 粉丝团 任务 任务 粉丝团 粉丝团 等级 	功能-粉丝团
直播 用户 粉丝团 关系 直播 用户 粉丝团 关系 主播侧 粉丝团 主播侧 粉丝团 粉丝团 行为 粉丝团 任务 任务 消费 交叉 粉丝团 任务 任务 电商 任务 粉丝团 任务 粉丝团 任务 任务 粉丝团 粉丝团 等级 	营收产品-粉丝团
房间 直播 流量 入口 直播 流量 入口 房间 观看 业务 用户数 抖音 火山 直播间 流量 入口 抖音 监控 流量 抖音 火山 直播间 流量 入口 拆分 抖音 火山 直播间 流量 入口 拆分 	直播间-流量
处置 处置 主播 直播间 观众 处置 生态 健康 处置 直播间 主播 观众 生态 健康 处置 核心 安全 审核 处置 生态 健康 主播 流量 等级 健康 	生态健康-处置能力
抖 聊天室 聊天室 抖 聊天室 行为 聊天室 行为 	功能-聊天室
抖 聊天室 聊天室 社交 场景 付费 连线 订单 社交 场景 付费 连线 订单 连麦 用户 最后 连麦 用户 最后 行为 时间 互动 社交 用户 观看 行为 时间 分端 互动 社交 看播 连线 用户 画像 标签 主播 聊天室 抖音 火山 聊天室 主播 多人 场景 核心 场景 核心 多人 场景 嘉宾 多人 玩法 主播 嘉宾 连线 聊天室 付费 连线 多人 场景 分层 主播 语音 直播 核心 聊天室 直播 伴侣 	多人场景-基础产品
主播 连屏 连屏 场次 连屏 玩法 主播 用户 消费 交叉 场景 玩法 场次 营收 主播 交叉 连屏 订单 连屏 订单 连屏 玩法 场次 营收 连屏 玩法 抖 流量 入口 pk 流量 交叉 流量 入口 连屏 流量 交叉 时间 分析 pk 封禁 营收 连屏 封禁 主播 连屏 连屏 玩法 玩法 	营收产品-连屏
主播 连屏 连屏 场次 连屏 玩法 主播 用户 消费 交叉 场景 玩法 场次 营收 主播 交叉 连屏 订单 连屏 订单 连屏 玩法 场次 营收 连屏 玩法 抖 流量 入口 pk 流量 交叉 流量 入口 连屏 流量 交叉 时间 分析 pk 封禁 营收 连屏 封禁 主播 主播 双人 PK 互关 行为 主播 双人 PK 互关 行为 互关 pk 业务 互关 连屏 连屏 玩法 玩法 	功能-连屏
公会 画像 公会 分层 建联 建联 主播 主播 公会 运营 标签 公会 运营 标签 公会 公会 主播 公会 主播 主播 主播 运营 核心 公会 主播 运营 经纪人 分析 公会 拉新 直播间 招募 公会 运营 公会 语音 聊天室 视频 拉新 任务 监控 主播 监控 公会 招募 生态 健康 公会 治理 公会 游戏 分成 	主播中心-机构运营
直播间 标签 直播间 标签 投票 	直播间-画像
直播 礼物 维度 直播 礼物 维度 礼物 集市 送礼 礼物 送礼 观众 礼物 消费 观众 礼物 消费 用户 送礼 行为 交叉 用户 送礼 行为 交叉 礼物 商品 礼物 商品 礼物 抖音 礼物 大盘 直播 礼物 合作 	功能-礼物
直播 流量 入口 直播 流量 入口 主播 流量 抖音 监控 流量 垂类 主播 流量 拆分 打赏 项目 流量 	主播-流量
直播 流量 入口 直播 流量 入口 抖音 监控 流量 	观众-流量
充值 订单 全量表 充值 订单 充值 充值 全量表 充值 日报 充值 订单 充值 充值 直播 钱包 充值 直播 钱包 订单 直播 充值 充值 漏斗 	直播钱包-充值
礼物 集市 送礼 礼物 送礼 观众 礼物 消费 观众 礼物 消费 用户 送礼 行为 交叉 用户 送礼 行为 交叉 礼物 商品 礼物 商品 礼物 观众 礼物 消费 观众 礼物 消费 礼物 抖音 礼物 大盘 礼物 道具 直播 礼物 合作 礼物 送礼 行为 	营收产品-礼物
订单 多人 连屏 订单 订单 流量 入口 流量 入口 订单 订单 流量 入口 入口 流量 入口 火山 火山 火山 入口 流量 场景 订单 流量 入口 直播 内容 付费 订单 直播 内容 付费 订单 订单 全量表 订单 全量表 消费 退款 订单 全量表 订单 全量表 消费 退款 	直播钱包-消费订单
用户 消费 分层 营收 活动 抖火 业务 营收 分层 抖火 业务 营收 分层 全量表 主播 营收 分层 营收 活动 活动 榜单 大盘 大盘 	直播活动-基础建设
用户 账户 用户 账户 用户 账户 账户 用户 账户 账户 	直播钱包-账户
用户 账户 用户 账户 荣誉 等级 用户 基础 荣誉 等级 用户 基础 分析 用户 荣誉 等级 荣誉 等级 分析 用户 等级 时间 特权 	营收产品-荣誉等级
用户 账户 用户 账户 荣誉 等级 用户 基础 荣誉 等级 用户 基础 分析 用户 荣誉 等级 荣誉 等级 分析 用户 等级 时间 特权 	功能-荣誉等级
VS 节目 开播 房间 节目 开播 房间 流量 节目 流量 核心 交叉 节目 流量 入口 核心 交叉 线上 识别 线上 识别 节目 流量 交叉 节目 流量 交叉 流量 入口 流量 入口 	直播节目-基础建设
直播间 游戏 合作 房间 标签 游戏 合作 直播 房间 合作 标签 游戏 生态 治理 核心 游戏 治理 核心 打赏 主播 核心 打赏 主播 核心 电商 电商 直播 安全 直播 安全 主播 营收 分层 主播 分层 垂类 维度 主播 大盘 处罚 申诉 处置 主播 营收 分层 主播 分层 垂类 维度 主播 大盘 处罚 申诉 处置 治理 主播 违规 治理 场景 违规 治理 主播 违规 治理 场景 违规 生态 治理 游戏 治理 核心 直播 生态 治理 游戏 治理 核心 视频 生态 健康 商业化 核心 生态 健康 垂类 主播 生态 治理 直播 生态 健康 生态 健康 生态 健康 垂类 生态 健康 社区 治理 主播 监控 生态 健康 公会 治理 生态 健康 游戏 	生态健康-业务治理
直播 金主 用户 分端 直播 金主 用户 分端 vip 用户 业务 vip vip 核心 vip 核心 标签 vip 用户 vip 建联 用户 vip 场景 核心 标签 vip 历史 消费 用户 历史 vip 建联 用户 vip 用户 vip 直播 金主 用户 金主 用户 金主 运营 金主 全量表 金主 运营 金主 全量表 西瓜 业务 vip 抖 历史 用户 消费 用户 业务 vip vip 用户 历史 消费 用户 消费 用户 vip 场景 标签 标签 vip 用户 vip vip 等级 金主 日报 vip 安全 抖火 金主 金主 建联 金主 建联 	观众-VIP
vip 用户 业务 vip vip 核心 vip 核心 标签 vip 用户 vip 建联 用户 vip 场景 核心 标签 vip 历史 消费 用户 历史 vip 建联 用户 vip 用户 vip vip vip vip 安全 金主 建联 金主 建联 	营收产品-VIP
用户 直播 权限 封禁 申诉 全量表 用户 直播 权限 封禁 申诉 全量表 客服 举报 申诉 客服 举报 申诉 退款 全量表 退款 全量表 全量表 全量表 申诉 申诉 核心 申诉 核心 用户 申诉 申诉 生态 健康 申诉 核心 生态 健康 退款 生态 健康 申诉 生态 健康 处置 生态 健康 生态 健康 申诉 生态 健康 封禁 申诉 生态 健康 客服 举报 申诉 	生态健康-社区服务
用户 直播 权限 封禁 申诉 全量表 用户 直播 权限 封禁 申诉 全量表 直播间 举报 直播间 举报 直播间 处置 处置 直播间 处置 处置 业务 处置 直播间 处置 处置 直播间 惩罚 直播间 直播间 处置 处置 直播间 直播间 处置 封禁 直播 权限 账号 封禁 处置 直播 权限 账号 封禁 直播间 处置 处置 直播间 处置 处置 直播间 直播间 直播间 处置 处置 直播间 直播间 处置 处置 直播间 处置 处置 举报 举报 举报 直播间 举报 举报 直播间 直播间 处置 处置 直播间 处置 处置 直播间 处置 封禁 直播 权限 账号 封禁 封禁 处置 直播 权限 直播间 处置 处置 举报 举报 直播间 举报 直播间 直播间 处置 处置 直播间 举报 举报 直播间 举报 直播间 直播间 处置 处置 直播间 直播间 处置 处置 直播间 直播间 处置 处置 直播间 直播间 处置 处置 直播间 直播间 处置 封禁 直播 权限 账号 封禁 封禁 处置 封禁 直播 权限 封禁 账号 封禁 直播间 处置 封禁 直播 权限 账号 封禁 封禁 处置 直播 权限 账号 封禁 封禁 封禁 直播间 处置 封禁 直播 权限 账号 封禁 封禁 处置 直播 权限 账号 封禁 封禁 封禁 直播间 处置 流量 处置 流量 	直播间-安全
主播 运营 主播 运营 新主播 业务 主播 方舟 链路 新主播 新主播 新主播 业务 白名单 主播 白名单 主播 中心 主播 行为 开播 主播 中心 主播 行为 开播 主播 垂类 主播 业务 中心 抖音 火山 业务 主播 历史 主播 垂类 主播 垂类 主播 业务 垂类 核心 大盘 主播 中心 新主播 核心 运营 核心 运营 核心 多人 垂类 主播 主播 流量 主播 中心 多人 垂类 主播 主播 语音 聊天室 视频 拉新 任务 监控 中心 抖音 火山 主播 历史 主播 主播 监控 垂类 垂类 主播 流量 拆分 打赏 项目 流量 	主播中心-主播运营
用户 标签 状态 全量表 用户 标签 状态 主播 直播间 主播 直播间 主播 主播 生态 健康 核心 生态 健康 生态 健康 标签 生态 健康 主播 生态 健康 主播 直播间 	生态健康-专项-认证
主播 内容 标签 内容 标签 主播 营收 标签 主播 营收 标签 虚拟 主播 房间 虚拟 主播 房间 虚拟 主播 虚拟 主播 主播 内容 标签 审核 主播 内容 标签 审核 虚拟 主播 任务 虚拟 主播 任务 虚拟 主播 任务 虚拟 主播 任务 直播 伴侣 核心 监控 直播 虚拟 直播 核心 直播 伴侣 垂类 监测 虚拟 开播 	用户社区-行业产品
社区 核心 大盘 社区 核心 大盘 直播 主播 核心 大盘 直播 主播 核心 大盘 社区 粉丝 社区 核心 社区 核心 社区 用户 直播 业务 核心 标签 核心 核心 抖音 直播 抖音 抖音 火山 直播间 流量 入口 拆分 抖音 火山 直播间 流量 入口 拆分 	用户社区-核心指标
红包 红包 红包 用户 红包 用户 红包 	功能-红包
红包 红包 直播 抽奖 直播 抽奖 福袋 房间 福袋 福袋 最后 红包 用户 红包 用户 福袋 福袋 用户 用户 用户 用户 时间 直播间 红包 福袋 	用户社区-互动&体验
直播 抽奖 直播 抽奖 福袋 房间 福袋 福袋 最后 福袋 福袋 用户 用户 用户 用户 时间 直播间 福袋 	功能-福袋
直播 商品 维度 直播 商品 维度 公会 公会 直播 抽奖 直播 抽奖 	功能-商品
神秘 商店 任务 礼物 神秘 商店 任务 礼物 神秘 商店 用户 消费 用户 商品 用户 神秘 商店 场次 神秘 商店 活动 用户 消费 充值 活动 神秘 商店 活动 用户 消费 充值 活动 神秘 商店 活动 用户 神秘 商店 用户 消费 用户 商品 用户 	功能-神秘商店
神秘 商店 任务 礼物 神秘 商店 任务 礼物 神秘 商店 用户 消费 用户 商品 用户 神秘 商店 场次 神秘 商店 活动 用户 消费 充值 活动 神秘 商店 活动 用户 消费 充值 活动 神秘 商店 活动 用户 神秘 商店 用户 消费 用户 商品 用户 	营收产品-神秘商店
生态 健康 生态 健康 生态 健康 生态 健康 平台 生态 健康 平台 	生态健康-问题发现
观众 付费 观众 付费 设备 维度 直播 抖 直播 消费 设备 	设备-消费
主播 自然 自然 直播 主播 核心 大盘 直播 主播 核心 大盘 主播 西瓜 头条 主播 开播 观看 行为 西瓜 头条 主播 开播 观看 行为 西瓜 头条 业务 主播 开播 观看 行为 中心 抖音 火山 业务 主播 历史 主播 主播侧 	主播-综合
主播 自然 自然 	主播中心-基础建设
流水 全量表 流水 全量表 抖音 钱包 订单 账户 	直播钱包-提现
主播 心愿 主播 心愿 心愿 心愿 	营收产品-心愿单
主播 心愿 主播 心愿 心愿 心愿 	功能-心愿单
麦序 时间 全量表 主播 历史 麦序 主播 核心 麦序 	功能-麦序房
多人 玩法 订单 玩法 订单 社交 场景 付费 连线 订单 社交 场景 付费 连线 订单 多人 玩法 垂直 场景 订单 玩法 垂直 场景 订单 多人 场景 多人 场景 多人 玩法 营收 垂直 场景 消费 垂直 场景 消费 用户 房间 交叉 直播 营收 拆分 装扮 营收 	多人场景-增值营收
营收 行为 榜单 主播 用户 交叉 用户 榜单 营收 行为 用户 	营收产品-榜单
营收 行为 榜单 主播 用户 交叉 用户 榜单 营收 行为 用户 活动 榜单 	功能-榜单
设备 内容 行为 设备 内容 行为 设备 维度 直播 抖 	设备-互动
直播 用户 分层 分端 直播 用户 分层 分端 行为 画像 直播 收入 集市 流量 直播 收入 集市 流量 直播 用户 行为 分端 直播 用户 行为 分端 直播 用户 行为 分端 直播 用户 行为 分端 	直播钱包-金币
直播 营收 充值 退款 直播 营收 充值 退款 直播 钱包 充值 退款 退款 订单 全量表 订单 全量表 消费 退款 订单 全量表 订单 全量表 消费 退款 用户 退款 用户 退款 直播 付费 内容 订单 退款 直播 付费 内容 退款 	直播钱包-退款
直播 钱包 直播 流量 	直播钱包-流量&行为
直播 安全 核心 维度 直播 安全 核心 维度 处置 分布 处置 分布 直播 安全 核心 内容 维度 直播 安全 核心 内容 维度 核心 核心 业务 治理 安全 看播 业务 治理 安全 看播 直播 安全 核心 直播 安全 核心 标签 标签 标签 标签 生态 治理 治理 生态 治理 核心 生态 治理 核心 	生态健康-核心指标
节目 流量 核心 交叉 节目 流量 入口 核心 交叉 节目 流量 交叉 节目 流量 交叉 节目 核心 节目 核心 节目 节目 核心 直播 视频 直播 视频 离线 节目 直播 项目 直播间 离线 节目 离线 节目 送礼 核心 	直播节目-互动&行为
直播 道具 直播 道具 道具 用户 道具 状态 用户 道具 用户 道具 道具 道具 消费 红包 福袋 道具 消费 流水 平台 交易 订单 	功能-道具
直播 道具 直播 道具 道具 用户 道具 状态 用户 道具 用户 道具 道具 道具 消费 红包 福袋 道具 消费 流水 平台 交易 订单 	营收产品-道具
抖火 抖火 	功能-K歌
主播 中心 直播间 直播间 离线 直播 直播间 分析 视频 西瓜 业务 直播间 拆分 西瓜 业务 直播间 拆分 中心 抖音 火山 业务 直播间 拆分 开播 房间 	直播间-综合
直播 预约 用户 状态 直播 预约 用户 状态 直播 视频 直播 视频 	功能-预约
直播 预约 用户 状态 直播 预约 用户 状态 直播 视频 直播 视频 节目 集市 节目 场次 预约 行为 节目 集市 节目 场次 预约 行为 节目 集市 预约 行为 节目 集市 预约 行为 离线 节目 直播 预约 	直播节目-直播预约
打赏 主播 核心 打赏 主播 核心 治理 监控 生态 治理 直播 生态 健康 生态 健康 生态 治理 社区 安全 核心 生态 健康 业务 治理 监控 生态 健康 付费 直播 生态 健康 场景 核心 生态 健康 核心 	生态健康-社区安全
直播 盲盒 道具 直播 盲盒 道具 盲盒 客服 盲盒 业务 核心 	功能-盲盒
直播 盲盒 道具 直播 盲盒 道具 盲盒 客服 盲盒 业务 核心 	营收产品-盲盒
特权 消费 流水 特权 	功能-特权
特权 消费 流水 特权 	营收产品-特权
营收 关系 入口 流量 场景 订单 流量 入口 火山 火山 火山 	营收产品-经营策略
用户 权限 	主播中心-用户运营
业务 设备 设备 	设备-基础
公会 公会 识别 	功能-人气卡
节目 集市 观众 节目 礼物 消费 节目 集市 观众 节目 礼物 消费 离线 节目 业务 直播间 消费 离线 节目 礼物 消费 分端 离线 节目 送礼 核心 	直播节目-增量营收
观众 观众 抖火 用户 历史 看播 消费 用户 用户 	观众-综合
直播 直播 主播 直播 主播 直播间 直播间 功能 	多人场景-直播矩阵
直播 营收 直播 营收 直播 钱包 	直播钱包-追偿
节目 交叉 节目 互动 行为 交叉 	直播节目-节目回放
活动 活动 	直播活动-核心指标
离线 节目 内容 基础 离线 节目 直播 项目 直播间 离线 节目 核心 抖火 节目 核心 抖火 离线 节目 基础 维度 抖火 	直播节目-核心指标
直播 主播 流量 直播 监控 营销 组件 监控 	用户社区-分发&生态
直播 任务 中心 核心 	营收产品-金币
主播 公会 活动 	主播中心-主播活动
多人 场景 基础 核心 会员 核心 聊天室 核心 多人 营收 核心 核心 	多人场景-核心指标
离线 内容 直播 	直播节目-优质内容
平台 结算 	直播钱包-综合
游戏 联运 	直播钱包-交易
互动 游戏 核心 	多人场景-多行业
离线 直播 离线 直播 监控 	直播节目-共创直播
pk 	直播活动-营收活动
离线 开播 离线 节目 核心 	直播节目-垂类直播
